Date;Joueur;Scores;Sets joues;Sets gagnes;Sets perdus;Developpement;Points
15/09/2021 22:00;Marin;0;2;0;2;40;960
15/09/2021 22:00;Colas;2;2;2;0;40;1040
16/09/2021 19:54;LL;1;4;1;3;40;973
16/09/2021 19:54;Colas;3;6;5;1;40;1067
17/09/2021 17:49;KRa;0;2;0;2;40;971
17/09/2021 17:49;Colas;2;8;7;1;40;1096
18/09/2021 15:44;Marin;2;5;2;3;40;982
18/09/2021 15:44;LL;1;7;2;5;40;951
19/09/2021 13:38;LL;3;12;5;7;40;982
19/09/2021 13:38;Marin;2;10;4;6;40;951
20/09/2021 11:33;LL;3;16;8;8;40;1012
20/09/2021 11:33;Marin;1;14;5;9;40;921
21/09/2021 09:28;Sutter;2;5;2;3;40;980
21/09/2021 09:28;Gessien;3;5;3;2;40;1020
22/09/2021 07:23;KRa;2;4;2;2;40;1018
22/09/2021 07:23;Gessien;0;7;3;4;40;973
23/09/2021 05:17;Mateos;3;3;3;0;40;1055
23/09/2021 05:17;Sutter;0;8;2;6;40;925
24/09/2021 03:12;KRa;3;7;5;2;40;1086
24/09/2021 03:12;Mateos;0;6;3;3;40;987
25/09/2021 01:07;KRa;3;10;8;2;40;1124
25/09/2021 01:07;Mateos;0;9;3;6;40;949
25/09/2021 23:01;KRa;2;12;10;2;40;1147
25/09/2021 23:01;LL;0;18;8;10;40;989
26/09/2021 20:56;KRa;2;14;12;2;40;1158
26/09/2021 20:56;Marin;0;16;5;11;40;910
27/09/2021 18:51;KRa;3;17;15;2;40;1178
27/09/2021 18:51;Mateos;0;12;3;9;40;929
28/09/2021 16:46;KRa;3;20;18;2;40;1193
28/09/2021 16:46;Mateos;0;15;3;12;40;914
29/09/2021 14:40;KRa;3;24;21;3;40;1170
29/09/2021 14:40;Mateos;1;19;4;15;40;937
30/09/2021 12:35;Colas;3;12;10;2;40;1100
30/09/2021 12:35;Gessien;1;11;4;7;40;969
01/10/2021 10:30;KRa;3;27;24;3;40;1195
01/10/2021 10:30;PLN;0;3;0;3;40;975
02/10/2021 08:24;KRa;3;30;27;3;10;1213
02/10/2021 08:24;PLN;0;6;0;6;40;957
03/10/2021 06:19;Marin;2;21;7;14;40;912
03/10/2021 06:19;Gessien;3;16;7;9;40;967
04/10/2021 04:14;Marin;2;26;9;17;40;910
04/10/2021 04:14;PLN;3;11;3;8;40;959
05/10/2021 02:09;Colas;1;14;11;3;40;1082
05/10/2021 02:09;Gessien;1;18;8;10;40;985
06/10/2021 00:03;Colas;1;17;12;5;40;1028
06/10/2021 00:03;Marin;2;29;11;18;40;964
06/10/2021 21:58;Colas;2;19;14;5;40;1062
06/10/2021 21:58;LL;0;20;8;12;40;955
07/10/2021 19:53;Colas;2;21;16;5;40;1082
07/10/2021 19:53;Sutter;0;10;2;8;40;905
08/10/2021 17:48;Gessien;2;20;10;10;40;1020
08/10/2021 17:48;LL;0;22;8;14;40;920
09/10/2021 15:42;Gessien;1;22;11;11;40;1004
09/10/2021 15:42;Sutter;1;12;3;9;40;921
10/10/2021 13:37;Gessien;1;23;12;11;40;1020
10/10/2021 13:37;Marin;0;30;11;19;20;948
11/10/2021 11:32;Marin;1;32;12;20;20;946
11/10/2021 11:32;LL;1;24;9;15;40;924
12/10/2021 09:26;Sutter;1;13;4;9;40;941
12/10/2021 09:26;LL;0;25;9;16;40;904
13/10/2021 07:21;Marin;2;35;14;21;20;955
13/10/2021 07:21;Sutter;1;16;5;11;40;923
14/10/2021 05:16;Mateos;2;24;6;18;40;940
14/10/2021 05:16;Toujouse;3;5;3;2;40;997
15/10/2021 03:11;Mateos;2;29;8;21;40;941
15/10/2021 03:11;Toujouse;3;10;6;4;40;996
16/10/2021 01:05;Mateos;1;30;9;21;20;965
16/10/2021 01:05;Toujouse;0;11;6;5;40;972
16/10/2021 23:00;KRa;3;33;30;3;10;1216
16/10/2021 23:00;Mateos;0;33;9;24;20;958
17/10/2021 20:55;KRa;3;36;33;3;10;1219
17/10/2021 20:55;Mateos;0;36;9;27;20;951
18/10/2021 18:49;KRa;1;38;34;4;10;1212
18/10/2021 18:49;Mateos;1;38;10;28;20;966
19/10/2021 16:44;KRa;3;41;37;4;10;1214
19/10/2021 16:44;LL;0;28;9;19;40;894
20/10/2021 14:39;KRa;1;42;38;4;10;1214
20/10/2021 14:39;LL;0;29;9;20;40;891
21/10/2021 12:34;Mateos;3;41;13;28;20;987
21/10/2021 12:34;LL;0;32;9;23;20;848
22/10/2021 10:28;Mateos;0;42;13;29;20;973
22/10/2021 10:28;LL;1;33;10;23;20;862
23/10/2021 08:23;Xavier;0;3;0;3;40;940
23/10/2021 08:23;Alice;3;3;3;0;40;1060
24/10/2021 06:18;Xavier;3;8;3;5;40;1003
24/10/2021 06:18;Alice;2;8;5;3;40;997
25/10/2021 04:12;Xavier;1;9;4;5;40;1022
25/10/2021 04:12;Alice;0;9;5;4;40;978
26/10/2021 02:07;LL;3;38;13;25;20;883
26/10/2021 02:07;Sutter;2;21;7;14;40;881
27/10/2021 00:02;KRa;3;45;41;4;10;1218
27/10/2021 00:02;Mateos;0;45;13;32;20;965
27/10/2021 21:57;KRa;3;49;44;5;10;1214
27/10/2021 21:57;Mateos;1;49;14;35;20;974
28/10/2021 19:51;KRa;3;54;47;7;10;1201
28/10/2021 19:51;Mateos;2;54;16;38;20;1000
29/10/2021 17:46;KRa;1;55;48;7;10;1202
29/10/2021 17:46;Mateos;0;55;16;39;20;997
30/10/2021 15:41;KRa;3;58;51;7;10;1206
30/10/2021 15:41;PLN;0;14;3;11;40;943
31/10/2021 13:36;KRa;3;61;54;7;10;1209
31/10/2021 13:36;PLN;0;17;3;14;40;929
01/11/2021 11:30;KRa;3;64;57;7;10;1212
01/11/2021 11:30;PLN;0;20;3;17;40;917
02/11/2021 09:25;Sutter;0;24;7;17;40;847
02/11/2021 09:25;Mateos;3;58;19;39;20;1014
03/11/2021 07:20;Sutter;0;27;7;20;40;821
03/11/2021 07:20;Mateos;3;61;22;39;20;1027
04/11/2021 05:14;Sutter;1;31;8;23;20;833
04/11/2021 05:14;Mateos;3;65;25;40;20;1021
05/11/2021 03:09;PLN;1;24;4;20;40;941
05/11/2021 03:09;KRa;3;68;60;8;10;1206
06/11/2021 01:04;PLN;0;27;4;23;40;928
06/11/2021 01:04;KRa;3;71;63;8;10;1209
06/11/2021 22:59;PLN;0;30;4;26;20;916
06/11/2021 22:59;KRa;3;74;66;8;10;1212
07/11/2021 20:53;KRa;3;77;69;8;10;1217
07/11/2021 20:53;Mateos;0;68;25;43;20;1010
08/11/2021 18:48;KRa;3;82;72;10;10;1206
08/11/2021 18:48;Mateos;2;73;27;46;20;1033
09/11/2021 16:43;KRa;3;86;75;11;10;1205
09/11/2021 16:43;Mateos;1;77;28;49;20;1036
10/11/2021 14:37;KRa;1;87;76;11;10;1207
10/11/2021 14:37;Mateos;0;78;28;50;20;1032
11/11/2021 12:32;Colas;3;24;19;5;40;1097
11/11/2021 12:32;Sutter;0;34;8;26;20;826
12/11/2021 10:27;Colas;2;27;21;6;40;1071
12/11/2021 10:27;Sutter;1;37;9;28;20;839
13/11/2021 08:22;Sutter;3;41;12;29;20;865
13/11/2021 08:22;LL;1;42;14;28;20;857
14/11/2021 06:16;Mateos;3;81;31;50;20;1045
14/11/2021 06:16;Sutter;0;44;12;32;20;852
15/11/2021 04:11;Colas;2;30;23;7;20;1079
15/11/2021 04:11;Gessien;1;26;13;13;40;1012
16/11/2021 02:06;Colas;2;32;25;7;20;1084
16/11/2021 02:06;Sutter;0;46;12;34;20;847
17/11/2021 00:00;Colas;2;34;27;7;20;1089
17/11/2021 00:00;LL;0;44;14;30;20;852
17/11/2021 21:55;KRa;3;90;79;11;10;1215
17/11/2021 21:55;Colas;0;37;27;10;20;1072
18/11/2021 19:50;Slo;0;3;0;3;40;981
18/11/2021 19:50;KRa;3;93;82;11;10;1219
19/11/2021 17:45;Slo;0;6;0;6;40;965
19/11/2021 17:45;KRa;3;96;85;11;10;1223
20/11/2021 15:39;Slo;0;9;0;9;40;951
20/11/2021 15:39;KRa;3;99;88;11;10;1226
21/11/2021 13:34;KRa;3;102;91;11;10;1231
21/11/2021 13:34;Mateos;0;84;31;53;20;1034
22/11/2021 11:29;KRa;3;105;94;11;10;1236
22/11/2021 11:29;Mateos;0;87;31;56;20;1024
23/11/2021 09:24;KRa;3;109;97;12;10;1233
23/11/2021 09:24;Mateos;1;91;32;59;20;1030
24/11/2021 07:18;KRa;1;110;98;12;10;1234
24/11/2021 07:18;Mateos;0;92;32;60;20;1027
25/11/2021 05:13;Mateos;3;97;35;62;20;1017
25/11/2021 05:13;PLN;2;35;6;29;20;926
26/11/2021 03:08;Marin;3;41;17;24;20;965
26/11/2021 03:08;Pele;3;6;3;3;40;980
27/11/2021 01:02;Colas;3;41;30;11;20;1083
27/11/2021 01:02;Mateos;1;101;36;65;20;1006
27/11/2021 22:57;Colas;0;44;30;14;20;1045
27/11/2021 22:57;Mateos;3;104;39;65;20;1044
28/11/2021 20:52;Colas;0;47;30;17;20;1015
28/11/2021 20:52;Mateos;3;107;42;65;20;1074
29/11/2021 18:47;Alice;2;13;7;6;40;989
29/11/2021 18:47;Colas;2;51;32;19;20;1010
30/11/2021 16:41;Alice;0;15;7;8;40;979
30/11/2021 16:41;KRa;2;112;100;12;10;1236
01/12/2021 14:36;Colas;1;53;33;20;20;1024
01/12/2021 14:36;KRa;1;114;101;13;10;1229
02/12/2021 12:31;Sutter;3;51;15;36;20;885
02/12/2021 12:31;Gessien;2;31;15;16;20;936
03/12/2021 10:25;KRa;2;116;103;13;10;1230
03/12/2021 10:25;Sutter;0;53;15;38;20;882
04/12/2021 08:20;Colas;2;55;35;20;20;1037
04/12/2021 08:20;Gessien;0;33;15;18;20;923
05/12/2021 06:15;KRa;2;118;105;13;10;1233
05/12/2021 06:15;Colas;0;57;35;22;20;1030
06/12/2021 04:10;Sutter;2;56;17;39;20;896
06/12/2021 04:10;Gessien;1;36;16;20;20;909
07/12/2021 02:04;Colas;1;58;36;22;20;1035
07/12/2021 02:04;Sutter;0;57;17;40;20;891
07/12/2021 23:59;KRa;2;120;107;13;10;1234
07/12/2021 23:59;Gessien;0;38;16;22;20;906
08/12/2021 21:54;KRa;3;123;110;13;10;1236
08/12/2021 21:54;PLN;0;38;6;32;20;921
09/12/2021 19:48;KRa;3;126;113;13;10;1238
09/12/2021 19:48;PLN;0;41;6;35;20;916
10/12/2021 17:43;KRa;3;129;116;13;10;1240
10/12/2021 17:43;PLN;0;44;6;38;20;911
11/12/2021 15:38;Gessien;3;43;19;24;20;913
11/12/2021 15:38;Sutter;2;62;19;43;20;884
12/12/2021 13:33;Mateos;3;111;45;66;20;1088
12/12/2021 13:33;Colas;1;62;37;25;20;1021
13/12/2021 11:27;Mateos;3;115;48;67;20;1094
13/12/2021 11:27;Jacquet;1;4;1;3;40;987
14/12/2021 09:22;Mateos;0;120;48;72;20;1070
14/12/2021 09:22;KRa;5;134;121;13;10;1252
15/12/2021 07:17;KRa;3;137;124;13;10;1254
15/12/2021 07:17;Marin;0;44;17;27;20;960
16/12/2021 05:12;KRa;2;139;126;13;10;1256
16/12/2021 05:12;Jacquet;0;6;1;5;40;978
17/12/2021 03:06;KRa;2;141;128;13;10;1258
17/12/2021 03:06;Colas;0;64;37;27;20;1016
18/12/2021 01:01;Alice;0;16;7;9;40;955
18/12/2021 01:01;Gessien;1;44;20;24;20;925
18/12/2021 22:56;Alice;0;17;7;10;40;952
18/12/2021 22:56;KRa;1;142;129;13;10;1258
19/12/2021 20:50;Alice;0;18;7;11;40;933
19/12/2021 20:50;Marin;1;45;18;27;20;969
20/12/2021 18:45;Alice;0;19;7;12;40;917
20/12/2021 18:45;Jacquet;1;7;2;5;40;994
21/12/2021 16:40;Alice;0;20;7;13;40;905
21/12/2021 16:40;Colas;1;65;38;27;20;1022
22/12/2021 14:35;Marin;2;48;20;28;20;973
22/12/2021 14:35;Gessien;1;47;21;26;20;921
23/12/2021 12:29;Jacquet;1;10;3;7;40;958
23/12/2021 12:29;Gessien;2;50;23;27;20;939
24/12/2021 10:24;Colas;2;67;40;27;20;1037
24/12/2021 10:24;Jacquet;0;12;3;9;40;928
25/12/2021 08:19;Colas;0;76;40;36;20;1010
25/12/2021 08:19;KRa;9;151;138;13;10;1271
26/12/2021 06:13;Colas;3;80;43;37;20;1024
26/12/2021 06:13;Marin;1;52;21;31;20;959
27/12/2021 04:08;Colas;2;82;45;37;20;1042
27/12/2021 04:08;Roch;0;2;0;2;40;964
28/12/2021 02:03;Marin;2;54;23;31;20;979
28/12/2021 02:03;Roch;0;4;0;4;40;924
28/12/2021 23:58;Alice;0;21;7;14;40;887
28/12/2021 23:58;Roch;1;5;1;4;40;942
29/12/2021 21:52;Alice;0;22;7;15;40;874
29/12/2021 21:52;Marin;1;55;24;31;20;985
30/12/2021 19:47;Colas;2;84;47;37;20;1050
30/12/2021 19:47;Alice;0;24;7;17;40;857
31/12/2021 17:42;Colas;0;87;47;40;20;1041
31/12/2021 17:42;KRa;3;154;141;13;10;1275
01/01/2022 15:36;KRa;2;156;143;13;10;1276
01/01/2022 15:36;Pele;0;8;3;5;40;973
02/01/2022 13:31;Sutter;3;67;22;45;20;904
02/01/2022 13:31;Gessien;2;55;25;30;20;919
03/01/2022 11:26;Colas;2;90;49;41;20;1072
03/01/2022 11:26;KRa;1;159;144;15;10;1261
04/01/2022 09:21;Colas;1;94;50;44;20;1031
04/01/2022 09:21;PLN;3;48;9;39;20;952
05/01/2022 07:15;Bossard;3;3;3;0;40;1049
05/01/2022 07:15;PLN;0;51;9;42;20;928
06/01/2022 05:10;Bossard;3;6;6;0;40;1149
06/01/2022 05:10;KRa;0;162;144;18;10;1236
07/01/2022 03:05;Colas;0;97;50;47;20;1014
07/01/2022 03:05;Bossard;3;9;9;0;40;1183
08/01/2022 01:00;PLN;0;54;9;45;20;908
08/01/2022 01:00;Colas;3;100;53;47;20;1034
08/01/2022 22:54;Remi;0;2;0;2;40;989
08/01/2022 22:54;KRa;2;164;146;18;10;1238
09/01/2022 20:49;Colas;1;103;54;49;20;1011
09/01/2022 20:49;PLN;2;57;11;46;20;931
10/01/2022 18:44;Colas;2;105;56;49;20;1020
10/01/2022 18:44;LL;0;46;14;32;20;843
11/01/2022 16:38;KRa;3;167;149;18;10;1240
11/01/2022 16:38;PLN;0;60;11;49;20;926
12/01/2022 14:33;KRa;2;169;151;18;10;1241
12/01/2022 14:33;LL;0;48;14;34;20;840
13/01/2022 12:28;KRa;1;170;152;18;10;1241
13/01/2022 12:28;Alice;0;25;7;18;40;854
14/01/2022 10:23;Bossard;2;11;11;0;40;1191
14/01/2022 10:23;Sutter;0;69;22;47;20;900
15/01/2022 08:17;Bossard;2;13;13;0;40;1198
15/01/2022 08:17;Alice;0;27;7;20;40;847
16/01/2022 06:12;Sutter;2;71;24;47;20;915
16/01/2022 06:12;Alice;0;29;7;22;40;816
17/01/2022 04:07;KRa;2;173;154;19;10;1235
17/01/2022 04:07;Remi;1;5;1;4;40;1013
18/01/2022 02:01;KRa;2;175;156;19;10;1237
18/01/2022 02:01;Thibs;0;2;0;2;40;989
18/01/2022 23:56;Remi;2;7;3;4;40;1049
18/01/2022 23:56;Thibs;0;4;0;4;40;953
19/01/2022 21:51;Colas;2;107;58;49;20;1032
19/01/2022 21:51;Gessien;0;57;25;32;20;907
20/01/2022 19:46;Colas;0;109;58;51;20;1000
20/01/2022 19:46;LL;2;50;16;34;20;872
21/01/2022 17:40;Gessien;0;59;25;34;20;885
21/01/2022 17:40;LL;2;52;18;34;20;894
22/01/2022 15:35;PLN;1;63;12;51;20;922
22/01/2022 15:35;Pele;2;11;5;6;40;982
23/01/2022 13:30;PLN;2;65;14;51;20;947
23/01/2022 13:30;Antoine;0;2;0;2;40;949
24/01/2022 11:24;Pele;2;13;7;6;40;1016
24/01/2022 11:24;Antoine;0;4;0;4;40;915
25/01/2022 09:19;Bossard;2;15;15;0;10;1205
25/01/2022 09:19;LL;0;54;18;36;20;891
26/01/2022 07:14;KRa;2;177;158;19;10;1240
26/01/2022 07:14;Pele;0;15;7;8;40;1004
27/01/2022 05:09;Bossard;2;17;17;0;10;1216
27/01/2022 05:09;KRa;0;179;158;21;10;1229
28/01/2022 03:03;LL;2;57;20;37;20;913
28/01/2022 03:03;Pele;1;18;8;10;40;960
29/01/2022 00:58;Remi;0;9;3;6;40;1002
29/01/2022 00:58;Colas;2;111;60;51;20;1023
29/01/2022 22:53;PLN;2;67;16;51;20;964
29/01/2022 22:53;Sutter;0;73;24;49;20;898
30/01/2022 20:48;Colas;2;113;62;51;20;1038
30/01/2022 20:48;PLN;0;69;16;53;20;949
31/01/2022 18:42;Alice;0;31;7;24;20;796
31/01/2022 18:42;Thibs;2;6;2;4;40;973
01/02/2022 16:37;Gessien;2;61;27;34;20;907
01/02/2022 16:37;Antoine;0;6;0;6;40;871
02/02/2022 14:32;Thibs;0;8;2;6;40;924
02/02/2022 14:32;Gessien;2;63;29;34;20;931
03/02/2022 12:26;Alice;1;34;8;26;20;795
03/02/2022 12:26;Antoine;2;9;2;7;40;874
04/02/2022 10:21;Colas;3;116;65;51;20;1061
04/02/2022 10:21;Marin;0;58;24;34;20;962
05/02/2022 08:16;PLN;2;71;18;53;20;969
05/02/2022 08:16;Marin;0;60;24;36;20;942
06/02/2022 06:11;Colas;0;118;65;53;20;1035
06/02/2022 06:11;PLN;2;73;20;53;20;995
07/02/2022 04:05;KRa;3;182;161;21;10;1231
07/02/2022 04:05;Gessien;0;66;29;37;20;926
08/02/2022 02:00;KRa;3;185;164;21;10;1233
08/02/2022 02:00;Gessien;0;69;29;40;20;921
08/02/2022 23:55;Colas;3;122;68;54;20;1049
08/02/2022 23:55;Remi;1;13;4;9;40;973
09/02/2022 21:49;Marin;3;64;27;37;20;958
09/02/2022 21:49;Gessien;1;73;30;43;20;905
10/02/2022 19:44;Remi;2;18;6;12;40;928
10/02/2022 19:44;Gessien;3;78;33;45;20;927
11/02/2022 17:39;Colas;2;126;70;56;20;1036
11/02/2022 17:39;Marin;2;68;29;39;20;971
12/02/2022 15:34;KRa;3;188;167;21;10;1235
12/02/2022 15:34;Gessien;0;81;33;48;20;922
13/02/2022 13:28;KRa;3;193;170;23;10;1220
13/02/2022 13:28;Gessien;2;86;35;51;20;952
14/02/2022 11:23;Sutter;1;77;25;52;20;887
14/02/2022 11:23;Gessien;3;90;38;52;20;963
15/02/2022 09:18;PLN;1;74;21;53;20;1006
15/02/2022 09:18;Colas;0;127;70;57;20;1025
16/02/2022 07:12;Alice;0;35;8;27;20;793
16/02/2022 07:12;Colas;1;128;71;57;20;1027
17/02/2022 05:07;Alice;0;37;8;29;20;785
17/02/2022 05:07;Gessien;2;92;40;52;20;971
18/02/2022 03:02;LL;0;59;20;39;20;898
18/02/2022 03:02;Gessien;2;94;42;52;20;986
19/02/2022 00:57;LL;0;61;20;41;20;886
19/02/2022 00:57;PLN;2;76;23;53;20;1018
19/02/2022 22:51;Colas;3;131;74;57;20;1050
19/02/2022 22:51;Marin;0;71;29;42;20;948
20/02/2022 20:46;Marin;0;73;29;44;20;929
20/02/2022 20:46;Pele;2;20;10;10;40;998
21/02/2022 18:41;Colas;3;134;77;57;20;1074
21/02/2022 18:41;Pele;0;23;10;13;40;950
22/02/2022 16:36;KRa;3;196;173;23;10;1225
22/02/2022 16:36;PLN;0;79;23;56;20;1008
23/02/2022 14:30;KRa;3;199;176;23;10;1229
23/02/2022 14:30;PLN;0;82;23;59;20;999
24/02/2022 12:25;KRa;3;202;179;23;10;1233
24/02/2022 12:25;PLN;0;85;23;62;20;991
25/02/2022 10:20;KRa;3;205;182;23;10;1236
25/02/2022 10:20;Gessien;0;97;42;55;20;979
26/02/2022 08:14;KRa;3;208;185;23;10;1239
26/02/2022 08:14;Gessien;0;100;42;58;20;972
27/02/2022 06:09;PLN;3;88;26;62;20;1013
27/02/2022 06:09;Jacquet;0;15;3;12;40;883
28/02/2022 04:04;PLN;2;90;28;62;20;1023
28/02/2022 04:04;Jacquet;0;17;3;14;40;862
01/03/2022 01:59;Marin;1;77;30;47;20;913
01/03/2022 01:59;Pele;3;27;13;14;40;983
01/03/2022 23:53;Marin;0;78;30;48;20;906
01/03/2022 23:53;Pele;1;28;14;14;40;997
02/03/2022 21:48;KRa;3;212;188;24;10;1238
02/03/2022 21:48;Colas;1;138;78;60;20;1076
03/03/2022 19:43;KRa;3;215;191;24;10;1244
03/03/2022 19:43;Colas;0;141;78;63;20;1063
04/03/2022 17:37;KRa;3;218;194;24;10;1248
04/03/2022 17:37;PLN;0;93;28;65;20;1014
05/03/2022 15:32;KRa;3;221;197;24;10;1252
05/03/2022 15:32;PLN;0;96;28;68;20;1006
06/03/2022 13:27;KRa;1;223;198;25;10;1245
06/03/2022 13:27;PLN;1;98;29;69;20;1020
07/03/2022 11:22;KRa;3;227;201;26;10;1240
07/03/2022 11:22;Gessien;1;104;43;61;20;983
08/03/2022 09:16;Colas;3;145;81;64;20;1060
08/03/2022 09:16;LL;1;65;21;44;20;889
09/03/2022 07:11;Colas;3;149;84;65;20;1068
09/03/2022 07:11;Gessien;1;108;44;64;20;975
10/03/2022 05:06;KRa;3;231;204;27;10;1234
10/03/2022 05:06;Jacquet;1;21;4;17;40;887
11/03/2022 03:00;KRa;3;235;207;28;10;1228
11/03/2022 03:00;Jacquet;1;25;5;20;40;912
12/03/2022 00:55;KRa;3;238;210;28;10;1230
12/03/2022 00:55;Jacquet;0;28;5;23;40;902
12/03/2022 22:50;KRa;3;241;213;28;10;1232
12/03/2022 22:50;LL;0;68;21;47;20;884
13/03/2022 20:45;KRa;3;244;216;28;10;1235
13/03/2022 20:45;Gessien;0;111;44;67;20;968
14/03/2022 18:39;PLN;3;101;32;69;20;1044
14/03/2022 18:39;Gessien;0;114;44;70;20;944
15/03/2022 16:34;PLN;2;104;34;70;20;1044
15/03/2022 16:34;Gessien;1;117;45;72;20;944
16/03/2022 14:29;Remi;1;20;7;13;40;947
16/03/2022 14:29;Colas;1;151;85;66;20;1059
17/03/2022 12:24;Gessien;1;119;46;73;20;951
17/03/2022 12:24;PLN;1;106;35;71;20;1037
18/03/2022 10:18;Colas;2;153;87;66;20;1071
18/03/2022 10:18;Gessien;0;121;46;75;20;939
19/03/2022 08:13;PLN;2;108;37;71;20;1050
19/03/2022 08:13;Remi;0;22;7;15;40;921
20/03/2022 06:08;Colas;1;155;88;67;20;1070
20/03/2022 06:08;PLN;1;110;38;72;20;1051
21/03/2022 04:02;Remi;1;24;8;16;40;923
21/03/2022 04:02;Gessien;1;123;47;76;20;938
22/03/2022 01:57;PLN;1;115;39;76;20;1051
22/03/2022 01:57;KRa;4;249;220;29;10;1235
22/03/2022 23:52;Marin;0;83;30;53;20;897
22/03/2022 23:52;KRa;5;254;225;29;10;1239
23/03/2022 21:47;PLN;5;121;44;77;20;1059
23/03/2022 21:47;Marin;1;89;31;58;20;889
24/03/2022 19:41;Colas;3;159;91;68;20;1088
24/03/2022 19:41;PLN;1;125;45;80;20;1041
25/03/2022 17:36;PLN;3;128;48;80;20;1054
25/03/2022 17:36;LL;0;71;21;50;20;871
26/03/2022 15:31;Gessien;2;126;49;77;20;942
26/03/2022 15:31;Sutter;1;80;26;54;20;883
27/03/2022 13:25;Sutter;2;82;28;54;20;902
27/03/2022 13:25;LL;0;73;21;52;20;852
28/03/2022 11:20;KRa;2;256;227;29;10;1243
28/03/2022 11:20;Colas;0;161;91;70;20;1079
29/03/2022 09:15;KRa;2;258;229;29;10;1244
29/03/2022 09:15;Sutter;0;84;28;56;20;899
30/03/2022 07:10;KRa;2;260;231;29;10;1245
30/03/2022 07:10;Gessien;0;128;49;79;20;939
31/03/2022 05:04;Colas;2;163;93;70;20;1087
31/03/2022 05:04;Sutter;0;86;28;58;20;891
